1111111111
1000000001
1000111001
1001000001
1000111111
1110100001
1000001001
1011111001
1010000001
1010111101
1110000001
1000001111
1010111$01
1010000001
1111111111